NO                                  ./textures/eagle.xpm
WE ./textures/purplestone.xpm
EA                                                                 ./textures/greystone.xpm
SO                                   ./textures/redbrick.xpm
F 155,0        ,      0
C 0,100,100

1111111111111111111111111111
1000000001100000000000111111
1110000011100100N000000011
111000000000000000000000001
111111111111111111111111111111
