NO          ./textures/eagle.xpm
SO          ./textures/eagle.xpm
WE          ./textures/eagle.xpm
EA          ./textures/eagle.xpm
F 155,0        ,      0
C 0,100,100

1111111111111111111111111111
1000000001100001000000111111
111000001110010W000000000011
111000000000000000000000001
111111111111111111111111111111