NO          ./textures/eagle.xpm
SO ./textures/redbrick.xpm
WE ./textures/purplestone.xpm
EA ./textures/greystone.xpm
F 220,100        ,      0
C 225,30,0








111111111111111111111111
1000000000110000000000001
10000000001100000N0000001
111111111111111111111111


