NO          ./textures/eagle.xpm
SO ./textures/redbrick.xpm
WE ./textures/purplestone.xpm
EA ./textures/greystone.xpm
F 155,0        ,      0
C 0,100,100

1111111111111111111111111111
1000000001100001000000111111
1110000011100100S000000011
111000000000000000000000001
111111111111111111111111111111