NO          ./textures/eagle.xpm
SO ./textures/redbrick.xpm
WE ./textures/purplestone.xpm
EA ./textures/greystone.xpm
F 155,0        ,      0
C 0,100,100

1111111111111111111111111111
10000000011000000100000111111
11100000111001001S1000000011
1110000000000000010000000001
111111111111111111111111111111
