NO          ./textures/eagle.xpm
SO ./textures/barrel.xpm
EA ./textures/greystone.xpm
WE ./textures/purplestone.xpm
F 220,100        ,      0

C 225,30,0







1111111111111111111111111
100000000011000000000000W1
1000000000110000000000011
111111111111111111111111


